f0f0f0f0f0f0f0f0f0f0f0f0f0f0f0f0
f0f0f0f0f0f0f0f2f0f0f0f0f0f0f0f0
f0f0f0f0f0f0f0f2f0f0f0f0f0f0f0f0
f0f0f0f0f0f0f0f2f0f0f0h2h2f0f0f0
f0f0f0f0f0f0f0f2f0f0f0f0h2f0f0f0
f0f0f0w4w4w4w4f2w4w4w4w4h2f0f0f0
f0f0f0w4f2f2w4f2w4f2f2w4h2f0f0f0
f0h2h2h2h2h2h2f3h2h2h2h2h2f0f0f0
f0h4f0h2f0h4f0f2f0h4f0f0h4f0f0f0
f0f0f0h2f0f0f0f2f2f2f2f2f0f0f0f0
f0f0w1w1w1f0f0f0f0f0f0f2f0f0f0f0
f0f0w1f0w1f0f0f0f0f0f0f2f0f0f0f0
f0f0w1w1w1f0f0f0f0f0f0f2f0f0f0f0
f0f0f0f0f0f0f0f0f0f0f0f2f0f0f0f0
f0f0f0f0f0f0f0f0f0f0f0f2f0f0f0f0
f0f0f0f0f0f0f0f0f0f0f0f2f0f0f0f0
